# 1 2 3 4 5 6 7 8 9 
1 m 2 m m m 1 1 m m 
2 2 m 2 4 m m m m m 
3 m 2 m 1 m 3 2 m m 
4 m 4 1 m 1 m 6 5 2 
5 m m m 1 m 5 m m m 
6 1 m 3 m 5 m 1 m m 
7 1 m 2 6 m 1 m 3 m 
8 m m m 5 m m 3 m 2 
9 m m m 2 m m m 2 m 
