9 1 2 3 4 5 6 7 8 9
1 17 2 17 17 17 1 1 17 17
2 2 17 17 4 17 17 17 17 17
3 17 17 17 17 17 17 17 17 17
4 17 4 17 17 1 17 6 5 2
5 17 17 17 1 17 5 17 17 17
6 1 17 17 17 5 17 1 17 17
7 1 17 17 6 17 1 17 3 17
8 17 17 17 5 17 17 3 17 2
9 17 17 17 2 17 17 17 2 17
